200000000000
100010101000
111156111113
000008040011
051000000001
001000111011
011111000010
001001111110