000000000000
010100101000
210111111013
011011101110
001010000010
001010111010
011111101100
000000000000