200000000000
110000101000
111156111113
001108040010
051010000010
001000111010
011111101100
001000000000