000000000000
010100101000
210111111013
011111101110
001010000010
001000111010
011111101100
000000000000