000000000000
010100101000
212656111113
01110101001110
001010000010
001000111010
011111101100
000000000000